[Infralogic translationfile]
Language=Korean
Application=PlanCenter
[Translation]
MiscString3=InkNumber
Expose Control=노광조정
Configuration=설정
Input=핫폴더설정
On/Off=시작/정지
Running=실행
Output=출력
Device=출력기
Workload=워크로드
Action=동작구분
Progress=진행
Plate=플레이트
Template=템플리트
Plates=플레이트
Log=로그
Plate name=플레이트명
Color=컬러
Status=상태
Released=해제완료
Priority=등급
Poll time=폴 시간
Release time=해제시간
Output start=출력시작
Output done=출력완료
Filenumber=파일번호
Org. filename=Org.파일명
Show=표시
Delete=삭제
Device setup=출력기설정
Press setup=인쇄설정
Template setup=템플리트설정
Polled=폴완료
Imaging=이미징중
Imaged=이미징완료
Error=에러
All=모두선택
All not imaged=이미징 안된 전체파일
Color setup=컬러설정
Server setup=서버설정
Language setup=언어설정
Hot folder setup=핫폴더설정
Add=추가
Apply=적용
Edit=편집
Cancel=취소
OK=승인
Folder definition=폴더정의
Folder=폴더
Keep=유지
Color style=컬러스타일
Check file=파일체크
Input order=입력순서
Extention=확장
Name=이름
Size=사이즈
Width=가로
Height=세로
X=X
Advanced hotfolder options=확장 핫폴더 옵션
Template selection=템플리트 선택
Error detection=에러 감지
Color configuration=컬러 설정
Color definition=컬러 정의
Input name=입력 명
C=청
M=적
Y=황
K=먹
Workload balance configuration=워크로드설정
Max exposure time=최대 노광시간
Seconds=초
Max workload (0 is unlimited)=최대워크로드
Language=언어
Advanced=고급
Server connection=서버연결
Server name=서버명
Database name=데이타베이스명
User name=사용자
Password=암호
OS Authentication=OS 권한
Test=테스트
Select folder=선택폴더
New folder=새폴더
Refresh=새로고침
FormGlobaldefs=폼글로발정의
Missing=미싱
Polling=폴링중
Polling error=폴링에러
Resampling=리샘플링
Resampling error=샘플링에러
Ready=대기
Transmitting=전송중
Transmission error=전송에러
Transmitted=전송완료
Assembling=어셈블링
Assembling error=어셈블링에러
Assembled=어셀블링완료
Imaging error=이미징에러
Remote imaging=원격이미징
Verifying=수정중
Verify error=수정에러
Verified=수정완료
Killed=삭제완료
Preparing=준비중
Rotating=회전중
Yes=예
No=아니오
Connection test result=연결테스트 결과
Browse machine=장치탐색 
Advanced language setup=확장언어설정
Default=기본
Translation=전송
Initializing=초기화
Expose Center=Expose Center
Contents=컨텐츠
Initial setup wizard=초기설정 마법사
Database instance=데이타베이스 인스턴스
Next=다음
Abort=중지
Back=뒤로
Enter Control Center servername=CC서버명 입력
Control Center Lite configuration path=CCL설정경로
Control Center Lite log path=CCL로그경로
Browse=탐색
Rush=분산
lave en fejl=lave en fejl
Reimage=재이미지
Login=로그인
Approved=승인
Not approved=승인취소
No approval=승인대기
na=불가
Approval=승인중
Imaging start=이미징시작
Imaging done=이미징완료
External status change=외부연결변경
Username=사용자
Log in=로그인
Users=사용자
Confirm Password=경로 확인
User group=사용자그룹
Email=이메일
Page per row=페이지/열 
Refresh time=리프레쉬 시간
Label7=레이블7
Account enabled=계정활성
General settings=환경설정
Pagename=페이지명
Publication=매체
Edition=판
Section=섹션
Pagenumber=페이지번호
Ouput=출력
Advanced settings=환경설정
Actions=실행
Filename pre-processing=프리프로세싱 파일명
Filter=필터
Name recognition=약어명
Filename def.=파일명 정의
Expected input name=예상 입력명
Filename Style=파일명 종류
Separator=구분자
Regular expressions=정상표현
Use regular expressions=정상표현 사용
Regular expression testbed=정상표현 테스트배드
Test input filename=입력 파일명 테스트
Result=결과
Test match=비교 테스트
test format=테스트 포맷
External file renamer=외부파일 이름바꾸기
Path to script (blank when not used)=스크립트 경로(미사용시 공란)
Remark=세부내용
Full name=전체이름
Formmemos=폼메모
Text=텍스트
Shutdown=끄기
PlanCenter=PlanCenter
Pages=페이지
Planning=생산계획
Data=데이타
Thumbnails=섬네일
Multi selection=다중선택
One=단일
Colors=컬러
Sets=세트
Auto refresh=자동 리프레쉬
Issue=Issue
mastercopyseparationset=마스터복사분판세트
Lstat=Lstat
Colorstat=Colorstat
Ncolors=Ncolors
Thumbnailstuf=Thumbnailstuf
-=-
Approve=승인
Disapprove=승인취소
Release=해제
Hold=보류
Loaction=지역
Inactive pages/colors=비활성 페이지/컬러
Publication date=매체일자
Refresh filter=리프레쉬 필터
Location=분공장
Layout=레이아웃
Active=활성
Tower=Tower
Zone=인쇄지역
Cylinder=실린터
High/low=고/저
Stackposition=Stackposition
Press=인쇄
Run=실행
Flatseparation=플렛분판
Selection=선택
Marks=마크
Retransmit=재전송
Load=불러오기
Save=저장
Wizard=마법사
Calc. impose=터잡기 계산
Split pressrun=발행부수 할당
Edit colors=컬러편집
Location :=분공장 :
Ediorial plans=편집계획
Number of pages=페이지 수
Page progress=페이지 진행
Number of plates=인쇄판수
Plate progress=인쇄판 진행
Working=작동중
Settings=세팅
Fill=채우기
Copy page=페이지 복사
Paste page=페이지 붙여넣기
Re approve=재 승인
Server=서버
Job names=작업명
Stack position=Stack position
Half web=Half web
Show information=정보 보기
Program=프로그램
Preview=미리보기
Plate marks=인쇄판 마크
Delete pages=페이지 삭제
Re rip=재 리핑
Toolbars=도구 바
Cut=잘라내기
Close=닫기
Help=도움말
Export=보내기
Edit pagename=페이지명 편집
Change run=실행 변경
Select all=모두 선택
Select issue=Select issue
to=to
Select=선택
Proofer=교정기
Page type=페이지 형태
Save Page template=페이지 템플리트 저장
Formeditvariant=Formeditvariant
LabelCombo=라벨콤보
Label1=라벨1
Select colors=컬러선택
Get pages from pressrun=Get pages from pressrun
Create press plan=인쇄계획 만들기
Templates=Templates
Creep (mm pr. 100 pages)=Creep (mm pr. 100 pages)
Split into # runs=Split into # runs
Perfect bound=무선철
Consecutive=연속
Inserted=삽입완료
As one run=As one run
Collection mode=Collection mode
Split sections=섹션분할
<< Back=<< 뒤로
Next >>=다음>>
Printing date=인쇄일자
Need Approval=승인 요구
Locked=고정
Lock on import=불러오기 고정
Editorial production=편집생산
Offset=옵셋
Main edition=주 편집
Pageformat=페이지 포맷
FormInit=FormInit
Form1=폼1
Select theme=Select theme
Program theme=Program theme
Select press section number=인쇄 섹션번호 선택
Server configuration=서버구성
Network username=네트워크 사용자명
Network password=네트워크 패스워드
Instance=인스턴스
Database=데이터베이스
DB username=DB 사용자명
DB password=DB 패스워드
Network=네트워크
Instance or empty=인스턴스 또는 공란
Connect=연결
Logon=로그온
Currently connected to=현재 연결중
Edit page definitions=페이지 편집 정의
New=신규
Sub edition of=하위편집의
Sub edition=하위편집
Edition Type=편집형태
Insert as=Insert as
Split production=생산분할
Press run=인쇄 실행
<<Back=<<Back
Select lowest page on halfweb=Select lowest page on halfweb
Edit imposition=터잡기 편집
Edit plate=Edit 인쇄판 편집
Load press plan=인쇄계획 불러오기
Press template=인쇄 템플리트
Plan name=계획명
Info=Info
Add pressrun=발행부수 추가
Default colors=초기컬러
Sections=섹션
Start page=시작 페이지
End page=최종 페이지
Prefix=Prefix
Postfix=Postfix
Production Plan=생산계획
Fill with pages from=Fill with pages from
Application settings=어플리케이션 세팅
Application paths=어플리케이션 경로
Pagelist=페이지 목록
Thumbnail=섬네일
Press naming=인쇄 이름주기
Auto refresh time=자동 리프레쉬 시간
Auto login=자동 로그인
Lowres path=저해상 경로
Thumbnail path=섬네일 경로
Highres path=고해상 경로
Use editorial management=편집관리 사용하기
Auto scroll speed=자동 스크롤 속도
Sort pagename with pageindex=페이지인덱스로 페이지명 정렬
Hide filtered columns=필터링된 컬럼 감추기
Auto reset device when re imaging=재이미징시 출력기 자동 재살행
Double buffered=Double buffered
best fit=best fit
1:1=1:1
Start showings as=Start showings as
Show data on plate thumbnails=인쇄판 섬네일 데이터 보기
Show reimage dialog=재이미지 다이얼로그 보기
Default reset device device=출력기 출력기 초기화 재실행
Select all colors=모든 컬러선택
Tower names=Tower names
Cylinder names=Cylinder names
Stack position names=Stack position names
High / low names=고 / 저 이름
High=고
Low=저
Zone names=인쇄지역 명
Allow planning=Allow planning
Copy multible pages=Copy multible pages
By pagination=페이지수 분류
By pagename=페이지명 분류
FormSellwin=FormSellwin
Change layout=레이아웃 변경
RGB=RGB
Separated=분판된
Single color=단색
Reject=거부
Fit to screen=화면 일치
Show 1:1=1:1 보기
90 Degrees=90 도
180 Degrees=180 도
270 Degrees=270 도
Formselectfromlist=Formselectfromlist
Markgroups=마크그룹
Set priority=우선순위 지정
Calculate paring=페어링 계산
Reset device=출력기 재실행
Formlanguage=Formlanguage
Auto approval=자동 승인
Disapproved=승인취소완료
Production=생산
Pagina=Pagina
Page name=페이지명
Version=버전
External Status=외부 상태
Pub.Date=매체.일자
Proof template=교정 템플리트
Copy=복사
Pageposition=페이지위치
Sheet=Sheet
Sheet side=용지면
Proof status=교정 상태
Unique=Unique
Layer=레이어
Flatproofconfiguration=Flatproofconfiguration
Planpagename=계획페이지명
Inputtime=입력시간
ApproveTime=승인시간
ReadyTime=대기시간
OutputTime=출력시간
VerifyTime=조회시간
ApproveUser=승인자
FileName=파일명
LastError=최종에러
Comment=첨언
DeadLine=마감시간
InputID=입력 ID
Edit jobnames=작업명 편집
New pagename=신규 페이지명
Change production run=생산 실행 변경 
Plan=계획
Date=일자
Button1=Button1
CheckBox1=CheckBox1
CheckBox2=CheckBox2
Button2=Button2
Labelplatetext=Labelplatetext
Autorefresh=Autorefresh
Excel export=Excel export
Numeric status data=Numeric status data
Only selected data=Only selected data
Use icons=Use icons
Panorama=Panorama
Select anti panorama page=Select anti panorama page
Re proof=Re proof
Plate edit offset=Plate edit offset
Graphic=Graphic
Front/Back=Front/Back
Layout template=Layout template
Position=Position
Selected=Selected
Re image=Re image
Reimaging style=Reimaging style
Page datalist=Page datalist
Save press plan=Save press plan
Delete Press plan=Delete Press plan
File=File
About=About
Application=Application
(C) Copyright 2004  InfraLogic Aps.=(C) Copyright 2004  InfraLogic Aps.
LabelComment=LabelComment
Labelsystemtype=Labelsystemtype
Error log=Error log
Output  errors=Output  errors
EventTime=EventTime
Event=Event
Publication  date=Publication  date
Page=Page
ErrorMsg=ErrorMsg
Processid=Processid
BL=BL
Input  errors=Input  errors
Separation=Separation
Sort pagename as number=Sort pagename as number
Small=Small
Change press=Change press
Show as one run=Show as one run
Proof setup=Proof setup
Cover pages=Cover pages
Insert pages=Insert pages
Pageindex set by pagename=Pageindex set by pagename
Not missing=Not missing
Not transmitted=Not transmitted
Not Imaged=Not Imaged
Any error=Any error
Held=Held
Hide=Hide
Imposition missing=Imposition missing
Apply changes to=Apply changes to
Reproof the page=Reproof the page
No thumbnail selected=No thumbnail selected
Number of pages do not fit platelayout=Number of pages do not fit platelayout
Delete all selected pages=Delete all selected pages
Succes=Succes
Unable to logon=Unable to logon
Error in password=Error in password
Overwrite existing user=Overwrite existing user
Delete user=Delete user
Wrong user or password=Wrong user or password
Select proofconfiguration=Select proofconfiguration
Web proof path=Web proof path
Use webproof path=Use webproof path
Never=Never
Allways=Allways
Ask=Ask
Auto apply=Auto apply
Cylinder as shetnumber=Cylinder as shetnumber
Apply the plan now=Apply the plan now
Formcleanupfiles=Formcleanupfiles
Page dimenions=Page dimenions
Units=Units
X resolution=X resolution
Y resolution=Y resolution
Compression ratio=Compression ratio
Combine to one run=Combine to one run
N. pages=N. pages
Split=Split
Number of splits=Number of splits
Split Number=Split Number
Number of copies=Number of copies
Deadline (publication date + hours)=Deadline (publication date + hours)
Use all markgroups=Use all markgroups
Add production plan=Add production plan
Select layout template and section collection mode=Select layout template and section collection mode
Add press sections=Add press sections
Enter productname and  approval requirements=Enter productname and  approval requirements
TabSheet2=TabSheet2
HS=HS
Labelautosize=Labelautosize
Autosize=Autosize
Change columns=Change columns
Coloumn order=Coloumn order
Up=Up
Down=Down
Number of coloumns in grid=Number of coloumns in grid
CheckBox3=CheckBox3
Formdebugplan=Formdebugplan
Produce commonplate=Produce commonplate
Primary Issue=Primary Issue
Primary Edition=Primary Edition
No subeditions=No subeditions
Edition page planning=Edition page planning
Edition Pages=Edition Pages
Assign unique pages to editions=Assign unique pages to editions
Automatically use previous edition=Automatically use previous edition
Editions=Editions
Copyseparationset=Copyseparationset
Separationset=Separationset
CopyFlatseparationset=CopyFlatseparationset
Flatseparationset=Flatseparationset
Actionplanningchangecolors=Actionplanningchangecolors
Move plan=Move plan
Move to new press=Move to new press
Select new location and press=Select new location and press
Move production=Move production
Location (optional)=Location (optional)
New plan name=New plan name
Create production=Create production
Apply production=Apply production
Copy production=Copy production
Delete production=Delete production
BitBtn1=BitBtn1
Select plate layout=Select plate layout
Select the template for the new press=Select the template for the new press
Select location and press=Select location and press
Applying changes=Applying changes
Change plate layout=Change plate layout
Select a layout and optional marks=Select a layout and optional marks
Show thumbnails=Show thumbnails
Hide common pages=Hide common pages
Produce common plate=Produce common plate
Apply changes=Apply changes
Plate position=Plate position
Hide progress bar when show thumbnails=Hide progress bar when show thumbnails
Change stackposition=Change stackposition
Load pressplan=Load pressplan
Create a production base on pressplan from list=Create a production base on pressplan from list
External edit program and parameter for filename eg. c:\tiffedit.exe /=External edit program and parameter for filename eg. c:\tiffedit.exe /
Panorama Off=Panorama Off
plan problems=plan problems
Default K=Default K
Clear page table=Clear page table
Error loading global data=Error loading global data
Unable to connect to=Unable to connect to
check the network connection=check the network connection
Restart the program in order to change server=Restart the program in order to change server
Restart application to apply changes.  Retart now?=Restart application to apply changes.  Retart now?
Production must be applied before moving=Production must be applied before moving
Production must be applied before production can be copied=Production must be applied before production can be copied
Production must be applied before Colors can be changed=Production must be applied before Colors can be changed
Some pages cannot be common because of color difference=Some pages cannot be common because of color difference
Colors cannot be changed on dinkey "Halfweb" pages=Colors cannot be changed on dinkey "Halfweb" pages
There are no press plans=There are no press plans
Cannot find the file=Cannot find the file
File edit=File edit
Tiff files=Tiff files
External edit program for tif files=External edit program for tif files
Set status ripped after edit=Set status ripped after edit
Re approve after edit=Re approve after edit
PDF files=PDF files
External edit program for pdf files=External edit program for pdf files
Unable to copy file=Unable to copy file
Unable to save changes=Unable to save changes
Apply changes to control center file=Apply changes to control center file
Ask to save after edit=Ask to save after edit
Show full flat proof=Show full flat proof
Center spread=Center spread
Single spread=Single spread
Delete plate=Delete plate
Proof setup BW=Proof setup BW
Proof setup color=Proof setup color
Proof setup PDF=Proof setup PDF
Flat proof mode=Flat proof mode
Default colors K=Default colors K
Automatic proof selection=Automatic proof selection
Default colorproof=Default colorproof
Default BW proof=Default BW proof
Default PDFProof=Default PDFProof
Select proof from colors=Select proof from colors
No flat proof=No flat proof
Flat proof plan (automatic)=Flat proof plan (automatic)
Manual Flat proof=Manual Flat proof
Default flatproof=Default flatproof
Reload colors=Reload colors
Change proofer=Change proofer
reload colors automatic=reload colors automatic
Pageindex=Pageindex
DeviceID=DeviceID
ExternalStatus=ExternalStatus
Pubdate=Pubdate
ProofID=ProofID
PressRunID=PressRunID
CopyNumber=CopyNumber
TemplateID=TemplateID
SheetNumber=SheetNumber
Sheetside=Sheetside
PressTower=PressTower
PressZone=PressZone
PressCylinder=PressCylinder
PressHighLow=PressHighLow
Proofstatus=Proofstatus
UniquePage=UniquePage
FlatproofconfigurationID=FlatproofconfigurationID
Pagepositions=Pagepositions
locationid=locationid
PublicationID=PublicationID
EditionID=EditionID
SectionID=SectionID
IssueID=IssueID
ProductionID=ProductionID
ColorID=ColorID
PressID=PressID
Creep=Creep
plan allready exists with the same pages, add as new plan=plan allready exists with the same pages, add as new plan
Unable to make new plan=Unable to make new plan
Goto backup=Goto backup
Edit server=Edit server
Main server=Main server
Server instance=Server instance
Database user=Database user
Backup server (optional)=Backup server (optional)
Port=Port
Optimize=Optimize
Add subedition=Add subedition
Delete subedition=Delete subedition
Single run=Single run
Multi runs=Multi runs
Dynamic pairing=Dynamic pairing
Add copy=Add copy
Delete copy=Delete copy
Copies=Copies
Dynamic Pagepair system=Dynamic Pagepair system
Press run optimize=Press run optimize
Optimize production=Optimize production
Total number of plates=Total number of plates
Create new subedition as copy of=Create new subedition as copy of
Reapprove=Reapprove
New edition=New edition
Only unique pages=Only unique pages
Auto force=Auto force
Change names=Change names
Edit name=Edit name
Edit pagenames=Edit pagenames
On same cheet in all runs=On same cheet in all runs
Enable / disable colors=Enable / disable colors
Edit names=Edit names
Edit pages names=Edit pages names
Apply to all subeditions=Apply to all subeditions
Pre fix=Pre fix
Post fix=Post fix
Deadlock delay milliseconds=Deadlock delay milliseconds
Create=Create
Edit production=Edit production
GroupBox1=GroupBox1
Edit production plan=Edit production plan
Medium=Medium
Big=Big
Thumbnail size=Thumbnail size
Edit output settings=Edit output settings
Edit output and proof settings=Edit output and proof settings
Backup test=Backup test
Go to backup TEST=Go to backup TEST
The program have received a test message from BackupCenter=The program have received a test message from BackupCenter
Press OK to continue=Press OK to continue
Show doublets=Show doublets
Location production=Location production
Mono=Mono
Keep selecting=Keep selecting
PS path=PS path
RIP path=RIP path
Thumbnail caption=Thumbnail caption
Thumbnail sorting=Thumbnail sorting
Platetext=Platetext
Over all=Over all
Detail selection=Detail selection
Number of pages approved=Number of pages approved
Number of pages ready=Number of pages ready
Total number of pages=Total number of pages
Total number of unique pages=Total number of unique pages
Number of plates ready=Number of plates ready
Number of plates imaged=Number of plates imaged
Reimage production=Reimage production
Dont show all=Dont show all
Store jps local=Store jps local
Zoomstep=Zoomstep
Sidebar width=Sidebar width
Start showing as=Start showing as
1 : 1=1 : 1
Zoomed by:=Zoomed by:
Show sidebar=Show sidebar
Full flat preview path=Full flat preview path
Rip to mono=Rip to mono
RIP mono path=RIP mono path
RIP color path=RIP color path
Ink preview=Ink preview
Hold/Release=Hold/Release
Rip to Color=Rip to Color
Special=Special
Sidebar Height=Sidebar Height
Production tree=Production tree
Expand to level (-1=all, 0 none)=Expand to level (-1 = all, 0 none)
Approval options=Approval options
Remove missing colors=Remove missing colors
Relase on approval=Relase on approval
Release on approval=Release on approval
Use custom script=Use custom script
Custum release script=Custum release script
Ink preview path=Ink preview path
Clear all=Clear all
Set all=Set all
Approve Next=Approve Next
Reject Next=Reject Next
Next preview=Next preview
Plate preview=Plate preview
Remove copy=Remove copy
Delete old=Delete old
Relocate=Relocate
Force common pages=Force common pages
Date filter :=Date filter :
Show all=Show all
Date filter=Date filter
Advanced autorelease=Advanced autorelease
Keep selections=Keep selections
Datefilter all default=Datefilter all default
Min. page tree level=Min. page tree level
Release all colors=Release all colors
Filter tree=Filter tree
Run caption=Run caption
Edition Tab visible=Edition Tab visible
Planning tab visible=Planning tab visible
Production tab visible=Production tab visible
Plate tab visible=Plate tab visible
Log tab visible=Log tab visible
Button6=Button6
Button7=Button7
Delete all older than=Delete all older than
Release single edition if selected=Release single edition if selected
Visible tabs=Visible tabs
Page list=Page list
Edition plate=Edition plate
Edition local production=Edition local production
Color 2 Mono=Color 2 Mono
Report=Report
Device management=Device management
Select separation=Select separation
All copies=All copies
Inactive colors=Inactive colors
Read order=Read order
Show only unique pages=Show only unique pages
Next not approved=Next not approved
Next disapproved=Next disapproved
Small images=Small images
Hide common=Hide common
Pub date=Pub date
Productions=Productions
Re-order=Re-order
Move=Move
Delete template=Delete template
Side=Side
Type=Type
Pagindex=Pagindex
Common edition=Common edition
Index=Index
Ipage=Ipage
Master=Master
Time=Time
From=From
Errors only=Errors only
No errors=No errors
Events=Events
Logs=Logs
Preflight=Preflight
Rip=Rip
Proof=Proof
Transmission=Transmission
Ink estimation=Ink estimation
Approval / disapproval=Approval / disapproval
Hold / release=Hold / release
Combined=Combined
Process=Process
Message=Message
Jobname=Jobname
Included in combined log=Included in combined log
Combine=Combine
Find=Find
Excel=Excel
Print=Print
Devices=Devices
Label4=Label4
P=P
Logout=Logout
Refresh F5=Refresh F5
ToolbarsActionmanger=ToolbarsActionmanger
Configure toolbar=Configure toolbar
Configure users=Configure users
Save desktop settings=Save desktop settings
Reset toolbars=Reset toolbars
Single page=Single page
HighLow=HighLow
Configure tabs=Configure tabs
Configure email=Configure email
Configure colors=Configure colors
Configure jobnames=Configure jobnames
Change font=Change font
Select page=Select page
Select plate=Select plate
Select plate set=Select plate set
Combined plans=Combined plans
Quick load=Quick load
DB Tools=DB Tools
Delete publication=Delete publication
Full flatproof=Full flatproof
Archive=Archive
File info=File info
Missning=Missning
Paste=Paste
ActionPageFRelease=ActionPageFRelease
Relase=Relase
Save as sep. file=Save as sep. file
Customtools=Customtools
Plate settings=Plate settings
Change status=Change status
add submenu=add submenu
Rip system=Rip system
Add pages=Add pages
Press plan template name=Press plan template name
Save pressplan=Save pressplan
Save press runs as press template for later use=Save press runs as press template for later use
Append=Append
Auto=Auto
load a production based on pressplan from list=load a production based on pressplan from list
Plan parameters=Plan parameters
Platelayout template=Platelayout template
Plate output=Plate output
Allow unplanned colors=Allow unplanned colors
Minimum number of pages (0=all)=Minimum number of pages (0=all)
Plans=Plans
Keep selection on view change=Keep selection on view change
Datefilter set to all by default=Datefilter set to all by default
File paths=File paths
Hide date filter=Hide date filter
Upgrade db=Upgrade db
Rip to mono/color system=Rip to mono/color system
Pre title string=Pre title string
Post title string=Post title string
CheckBoxenableriptomono=CheckBoxenableriptomono
Visible coloumns=Visible coloumns
Page changes apply to all sub-editions=Page changes apply to all sub-editions
Plate preview path=Plate preview path
Default reset device on reimage=Default reset device on reimage
Expand to level (-1 = all, 0 none)=Expand to level (-1 = all, 0 none)
Plate font Bold=Plate font Bold
Cylinder as sheetnumber=Cylinder as sheetnumber
Select all markgroups by default=Select all markgroups by default
Default colors mono=Default colors mono
Auto force plate production=Auto force plate production
Press run range=Press run range
Range must be unique on all application where plans are run=Range must be unique on all application where plans are run
Default deadline=Default deadline
Defaults when working on unplanned pages=Defaults when working on unplanned pages
Planning method=Planning method
Use the plan wizard=Use the plan wizard
Load a plan=Load a plan
Always change the press=Always change the press
Default advanced apply settings=Default advanced apply settings
(If allowed by input folder settings)=(If allowed by input folder settings)
Activate only black separation=Activate only black separation
Show advanced tab=Show advanced tab
Default color PDF=Default color PDF
Select runs when saving=Select runs when saving
Zoomstep %=Zoomstep %
Show sidebar with separated previews=Show sidebar with separated previews
Comment as window caption=Comment as window caption
Email sender=Email sender
Email address=Email address 
Email server=Email server
Sender name=Sender name
Fixed name=Fixed name
Use username=Use username
Email information=Email information
Titel (N) for pagename (U) for user=Titel (N) for pagename (U) for user
Automatic=Automatic
Send email after disapproving=Send email after disapproving
Attach=Attach
Include=Include
Email image format=Email image format
Expand to level (-1 = all, 0 none)=Expand to level (-1 = all, 0 none)
Automatic remove missing colors on approval=Automatic remove missing colors on approval
reload colors automaticly=reload colors automaticly
Log these events in the database=Log these events in the database
Default settings for combined log=Default settings for combined log
Main highres archive folder=Main highres archive folder
Sub folder name=Sub folder name
Highres filename=Highres filename
Archive enabled=Archive enabled
Default highres=Default highres
Default lowres=Default lowres
Main lowres archive folder=Main lowres archive folder
Lowres filename=Lowres filename
Application settings for default behavior and appearance in different PlanCenter views=Application settings for default behavior and appearance in different PlanCenter views 
Lock all copies to same template=Lock all copies to same template
Rotate=Rotate
That need approval=That need approval
Resolution=Resolution
Lock all copies to same device i settings=Lock all copies to same device i settings
No change=No change
Hold new plates=Hold new plates
Halfweb template=Halfweb template
Admin login=Admin login
Popup menues=Popup menues
Plan editor=Plan editor
Select in all subeditions=Select in all subeditions
Exit=Exit
Clear=Clear
Set unique pages=Set unique pages
Edit run=Edit run
Debug=Debug
Button3=Button3
Production data=Production data
Production name=Production name
Set to unique=Set to unique
Select Loacation and press=Select Loacation and press
Change external status=Change external status
Double burn=Double burn
Imposition=Imposition
Select new press=Select new press
Posible presses=Posible presses
Select Press=Select Press
Select press on new location=Select press on new location
Load plan=Load plan
Select and run a press plan for one or more printsites / presses=Select and run a press plan for one or more printsites / presses
Plan templates=Plan templates
Plan settings=Plan settings
Pagenames=Pagenames
Form2=Form2
Apply plan to system=Apply plan to system
Select approval and hold parameters for production=Select approval and hold parameters for production
No change to existing pages=No change to existing pages
No change to existing plates=No change to existing plates
Owerwrite=Owerwrite
Apply mode=Apply mode
Edit press run=Edit press run
Edit edition / press run=Edit edition / press run
Edit sections and pages in the selected press run=Edit sections and pages in the selected press run
Tabs=Tabs
Save user settings=Save user settings
Save current tab, toolbar and popup setting to selected users=Save current tab, toolbar and popup setting to selected users
Recipient's=Recipient's
Notify=Notify
CC=CC
Attach preview=Attach preview
Notify on deadline=Notify on deadline
Deadline to=Deadline to
Deadline CC=Deadline CC
Sender=Sender
Deadline subject=Deadline subject
Mailserver=Mailserver
To (E-Mail)=To (E-Mail)
CC (E-Mail)=CC (E-Mail)
Mail server=Mail server
Attach email=Attach email
Email configuration=Email configuration
Configure recipients for page disapproval information=Configure recipients for page disapproval information
Send email=Send email
Title=Title
Extra information (optional)=Extra information (optional)
Send a email=Send a email
Send a email to these recipients about the disapproval of the page=Send a email to these recipients about the disapproval of the page
Recipients=Recipients
Sending emails=Sending emails
Emails about disapproval is being send please wait=Emails about disapproval is being send please wait
Formincludetolog=Formincludetolog
Configure combined log=Configure combined log
Select the events that are included in the combined log=Select the events that are included in the combined log
Find record=Find record
Search filter=Search filter
Save log=Save log
Set center spread=Set center spread
Apply a plan to unplanned pages=Apply a plan to unplanned pages
Apply production plan=Apply production plan
Select how to apply the plan to the pages=Select how to apply the plan to the pages
Options=Options
Change the press=Change the press
Edition order=Edition order
Set the order of the subeditions with the primary edition on top=Set the order of the subeditions with the primary edition on top
Delete press plans=Delete press plans
Load combined plans=Load combined plans
Load combined press plans=Load combined press plans
Set dealline=Set dealline
Quick load plans=Quick load plans
Done=Done
Insert=Insert
FormFTP=FormFTP
Production check=Production check
SQL=SQL
Manage=Manage
Fix DB=Fix DB
Information=Information
Open=Open
Exec=Exec
Load press plans=Load press plans
Runs=Runs
Append to press template=Append to press template
Append runs to plan=Append runs to plan
Select the press runs to append to the existing press template=Select the press runs to append to the existing press template
Press runs allready in plan=Press runs allready in plan
Press runs to include in plan=Press runs to include in plan
Automate planname=Automate planname
Select an entier publication and press delete=Select an entier publication and press delete
Archive options=Archive options
Save highres=Save highres
Save lowres=Save lowres
Archive files=Archive files
Archive page files=Archive page files
Select what files should be archived and where to place them=Select what files should be archived and where to place them
Archive highres files=Archive highres files
Archive lowres files=Archive lowres files
Copying files=Copying files
Highres file information=Highres file information
Inches (in)=Inches (in)
Millimeters (mm)=Millimeters (mm)
Picas=Picas
This shows the size and resolution of the selected file=This shows the size and resolution of the selected file
Copying page=Copying page
Custom tools=Custom tools
Tools=Tools
Auto stack=Auto stack
grbbox_1=grbbox_1
grbbox_2=grbbox_2
grbbox_3=grbbox_3
grbbox_4=grbbox_4
grbbox_5=grbbox_5
grbbox_6=grbbox_6
grbbox_7=grbbox_7
grbbox_8=grbbox_8
grbbox_9=grbbox_9
grbbox_10=grbbox_10
grbbox_11=grbbox_11
grbbox_12=grbbox_12
grbbox_13=grbbox_13
grbbox_14=grbbox_14
grbbox_15=grbbox_15
grbbox_16=grbbox_16
grbbox_17=grbbox_17
grbbox_18=grbbox_18
grbbox_19=grbbox_19
grbbox_20=grbbox_20
TabSheet3=TabSheet3
TabSheet4=TabSheet4
TabSheet5=TabSheet5
TabSheet6=TabSheet6
TabSheet7=TabSheet7
TabSheet8=TabSheet8
New planning=New planning
Press plan templates=Press plan templates
Page changes apply to all sub editions=Page changes apply to all sub editions
Pagetype=Pagetype
Proofed=Proofed
Presssectionnumber=Presssectionnumber
DB Index=DB Index
Old press run=Old press run
PlateNumber=PlateNumber
Expa=
